{
	"tileset2" : "chemin1.png",
	"terrain" : [
		[1, 3, 30, 27, 27, 28, 27, 27, 28, 85, 86, 87, 88, 28, 27],
		[27, 27, 27, 30, 27, 27, 28, 28, 27, 108, 109, 110, 111, 27, 28],
		[50, 50, 50, 50, 30, 50, 50, 50, 50, 131, 132, 133, 134, 30, 30],
		[48, 48, 48, 48, 37, 48, 48, 48, 48, 269, 270, 271, 272, 499, 499],
		[48, 48, 48, 48, 60, 48, 48, 48, 25, 315, 315, 315, 203, 499, 499],
		[48, 48, 48, 48, 60, 25, 25, 48, 25, 25, 25, 25, 48, 499, 499],
		[25, 25, 48, 25, 60, 25, 48, 25, 25, 60, 25, 25, 48, 415, 415],
		[48, 25, 25, 25, 60, 48, 25, 25, 48, 60, 25, 48, 25, 386, 386],
		[25, 48, 25, 25, 60, 48, 181, 182, 183, 184, 48, 25, 48, 415, 415],
		[48, 48, 25, 48, 25, 48, 204, 109, 110, 207, 25, 48, 25, 386, 386],
		[48, 25, 48, 25, 48, 25, 131, 132, 133, 134, 48, 25, 25, 499, 499],
		[25, 48, 25, 48, 25, 25, 177, 178, 179, 180, 25, 48, 25, 499, 499],
		[48, 48, 48, 48, 48, 25, 202, 315, 179, 179, 25, 25, 48, 415, 415],
		[48, 48, 48, 48, 48, 48, 25, 25, 25, 25, 48, 48, 48, 386, 386],
		[48, 48, 48, 48, 48, 48, 48, 48, 48,  48,  48,  48,  48,  499,  499]
	]
}